111111111111111
100000000000001
100011000110001
100011000110001
100000000000001
1000000C0000001
1P0000CCC000001
101100000001101
100011111110001
1000000000000E1
111111111111111
