1111111111111111111111111111111111111111111111111111111111111111111111111111
1P00000000000000000000000000000000000000000000000000000000000000000000000001
1000000000000000000000000000000000000000000000000000000000000000000000000001
10000000000000000000000000000000C0000000000000000000000000000000000000000001
1000000000000000000000000000000000000000000000000000000000000000000000000001
1000000000000000000000000000000000000000000000000000000000000000000000000C01
1000000000000000000000000000000001110000011100000000000000000000000000000001
1000000000000000000000000000000010001000100010000000000000000000000000000001
1000000000000000000000000000000010000101000010000000000000000000000000000001
1000000000000000000000000000000010000010000010000000000000000000000000000001
1000000000000000000000000000000001000000000100000000000000000000000000000001
1000000000000000000000000000000000100000001000000000000000000000000000000001
1000000000000000000000000000000000010000010000000000000000000000000000000001
1000000000000000000000000000000000001000100000000000000000000000000000000001
1000000000000000000000000000000000000101000000000000000000000000000000000001
1000000000000000000000000000000000000010000000000000000000000000000000000001
1000000000000000000000000000000000000000000000000000000000000000000000000001
1000000000000000000000000000000000C00000000000000000000000000000000000000001
10000000000000000000000000000000000CCCC0000000000000000000000000000000000001
1C00000000000000000000000000000000C00000000000000000000000000000000000000E01
1111111111111111111111111111111111111111111111111111111111111111111111111111
