1111111111111111111111111111111111
10000000000000111000000000000000001
11010101001001C1101001000000010101
1010010010101111001001000000011111
1P00000000000000000000000000000E11
1111111111111111111111111111111111
